11111111111111111111111
10000000000000001
10111111111111001
101C000000000C001
10101111111101001
10101C00000C01001
10101011111010001
1010101C0C001000111
10101010101010001
1P0101010100010001
10101010101010001
1010101C0C0010001
10101011111010001
10101C00000C01001
10101111111101001
101C000000000C001
10111111111111101
100000000000000E1
11111111111111111