1111111111111111111111111
1P00000001110000000000001
11CCC111110CCCCCCCCCCC001
10000000000000000000000C1
101CCCCCCCCCCCCCCCCCCCC01
1000000000000000000000001
10CCCCCC111111111111101C1
1000000000000000011110111
10CCC0000C1100000C111C111
1011CCCCCCCCCCCCC11101111
1000CCC001111000000000001
10CCCCCCCCCCCCCCCCCCCCC01
1000111111111000000000001
10CCCCCCCCCCCCCCCCCCCCC01
10000E0000000000000000001
1111111111111111111111111