1111111
1000001
1P0C001
1111001
100C0E1
1111111