111111000111111111
1100000101111
1111111111111
1111111101111
1111110111111
1111110101111
1111110111111
11111P0011111
1111111111111
1111111111111