1111111
10E00P1
1101C01
1111111
