111111111111111111111111111111111111111
1P00CCCC00CCCCCC00CCCCCC00CCCCCC0000001
100000CC000000CC000000CC000000CC0000001
100E00CC00CCCCCC00CCCCCC000000CC0000001
100C00CC000000CC000000CC000000CC0000001
100000CC00CCCCCC00CCCCCC000000CC0000001
111111111111111111111111111111111111111