1111111111111111111111111
100000CCCCCCCCCCCCCC00001
1P11111111110000000000001
100C000000000000000000001
1110111111111111111111101
1000C0CCCCCCCCCCCCCC00001
1110111111111111111111101
1111111111111CCCCCCCCCC01
1111111111111111111111101
10010000CC001110000010001
1000C0CCCCCCCCCCCCCC00001
10010000CC001110000010001
1E00010000000000010000001
10010000CC001110000010001
1000010000000000010000001
1111111111111111111111111
