1111111
10E00P1
1101001
1111111
