11111111111111111111111111111111111111111111111111111
100000000000000000000000000C000000000000P0000000000E1
11111111111111111111111111111111111111111111111111111